__________
__Y____B__
__Y____B__
__A____A__
____RW____
_G__RW__P_
_G__AA__P_
__________
___O__C___
___O__C___
___A__A___
