__________
_____W____
_____GW___
__W__BGW__
_WGW_CBGW_
WGBGSSCBGW
W________W
WROYSSRORW
_WROY_WRW_
__WRO__W__
___WR_____
____W_____
