__________
__________
____AA____
BB______BB
BB______BB
BB__PP__BB
PP__PP__PP
____PP____
__________
__________
____WW____
____WW____
_Y__YY__Y_
_Y______Y_
_Y______Y_
_A______A_
