__________
__________
WW_W__W_WW
_C_W__W_W_
_G_C__W_W_
_Y_G__W_W_
_O_Y__C_W_
_R_O__G_C_
_P_R__Y_G_
_B_PWWO_Y_
_C_B__R_O_
_W_C__P_R_
_W_W__B_P_
_W_W__C_B_
_W_W__W_C_
_W_W__W_W_
