__________
__________
__________
__________
____BB____
____BB____
____GG____
____GG____
____YY____
S_S_YY_S_S
_S_S__S_S_
S_S____S_S
_S_S__S_S_
S_S____S_S
