__________
__________
__________
__WW__WW__
_WWW__WWW_
_WBB__BBW_
_WBB__BBW_
_WBC__CBW_
_WBC__CBW_
__BC__CB__
____SS____
____SS_RR_
_______RR_
__O___RRR_
__OOOORRR_
___OOORR__
