__________
__________
R________G
R___PP___G
R__PPPP__G
R__PPPP__G
R_Y____C_G
R_Y____C_G
R_YYWWCC_G
RSSSSSSSSG
