__________
____A_____
____A_____
____A_____
____A_O_R_
____A__Y__
____A_R_O_
____A_____
____A_____
____A_____
____A_____
____AAAAAA
