W________W
_W_W__W_W_
__W_WW_W__
___RPPR___
_GY____YG_
_G__OO__G_
_GY____YG_
___RPPR___
__C_CC_C__
WWWWWWWWWW
